WWWWWWWWWWWWWWWWWWWW
W  P W   E         W
WW  WW WWWWWWWWWWWWW
W    E             W
W      WWWWWWWWWWWWW
W                  W
W   E              W
W                  W
WWWWWWWWWWWWWW     W
W       E          W
W        WWWWWWWWWWW
WWWWWWW            W
W       WWWWWWWWWWWW
W              E  TW
WWWWWWWWWWWWWWWWWWWW