WWWWWWWWWWWWWWWWWWWW
W  P W   E         W
WW  WW WWWWWWWWWWWWW
W    E             W
W      WWWWWWWWWWWWW
W          E   W   W
W   E              W
WWWWWWWWWWWW E E  WW
W          W       W
WW  WWWWWW W       W
W  WW    W   E     W
WW  WE   WWWWWWWWWWW
WWW W      W       W
W        W   W E  TW
WWWWWWWWWWWWWWWWWWWW